[
    [
        [ 0, 0, 2, 0, 1, 1, 1, 6 ],
        [ 0, 0, 0, 0, 3, 3, 3, 5 ],
        [ 0, 2, 0, 0, 0, 0, 1, 1 ],
        [ 0, 0, 0, 2, 0, 0, 3, 0 ],
        [ 0, 0, 0, 0, 0, 3, 0, 0 ],
        [ 0, 0, 0, 3, 3, 0, 0, 0 ],
        [ 0, 0, 3, 0, 0, 0, 2, 0 ],
        [ 4, 0, 0, 0, 0, 0, 0, 0 ]
    ],
    [
        "群馬県庁は33階建てで何と県庁舎として日本一の高さを誇っています。全国的に見ると現在大阪府咲洲庁舎、東京都庁についで3番目に高い建物ということになります。"
    ],
    [
        "./img/stagePanel6.png"
    ],
    [
        40, 30, 0
    ]
]
